R 700 500

EA ./srcs/textures/Walls/Sci-fi_wall1.xpm
NO ./srcs/textures/Walls/Sci-fi_wall5.xpm
SO ./srcs/textures/Walls/Sci-fi_wall2.xpm
WE ./srcs/textures/Walls/Sci-fi_wall6.xpm


S ./srcs/textures/norminet.xpm
F 110,90,50
C       20, 20, 150  

11111111111111111 
1000000000000000111 
11000000000000000011
1100000000000000001 
11000000000000000011
10000000000000000001
100000000000011111111111111
100010000100000000000000001
100000101000000000111111101
100000101000000000111111101
100000101000000000111111101
100000101000000000111211101
100000001000000000011011101
110000101000000000001000001
11000010100000000001111111111111
11000000000000000000000000000001
1000000E010000000001111111111111
11111111111111111111




