R 948 480
NO textures/wall_1.xpm
SO textures/wall_2.xpm
WE textures/wall_3.xpm
EA textures/wall_4.xpm
S textures/lion.xpm
F 184,113,39
C 51,198,227
11111111111111111111111111111
10000000021100000000000000001
10110000011100000000000010001
10210000000000000000000010001
10110000011100000000000010001
10000000001100000111011110001
11110111111111011100000010001
11110111111111011101010010001
11000000112121011100000010001
10000020000000001100000010001
12000000000000001101010010001
11000000110101000000200000001
11110111110101000000000000001
10000000001100000000002000001
10000000000000000000200000001
100000000010000000000000000W1
10000000001101000000000000001
10000000000100000001210000001
11111111111111111111111111111
