R 843 485
NO textures/absent
SO textures/absent
WE textures/absent
EA textures/absent
S textures/absent
F 184,113,9
C 5,98,227
11111111111111111111111111111
10000000001100000000000000001
10110000011100000000000010001
10010000000000000000000010001
10110000011100000000000010001
10000000001100000111011110001
11110111111111011100000010001
11110111111111011101010010001
11000000110101011100000010001
10000000000000001100000010001
10000000000000001101010010001
11000000110101000000000000001
11110111110101000000200000001
10000000001100000100000010001
10000000000000001010000101001
10000000001000010001010001001
10000000001101000000N00000001
10000000000100000001010000001
11111111111111111111111111111
