          F 51,87,56


   WE ./path_to_the_west_texture
	R 920 580

 NO ./path_to_the_north_texture

                            SO ./path_to_the_south_texture






       				EA ./path_to_the_east_texture

         S ./textures/elephant.xpm


C 179, 219, 242

        11111111111111111111111111
        10000200000110000000010001
        10110110011100001121000011
        1001020000000110011100101
111111111011000001110000000000121
120000000011000001110111111111111
11110111111111011100000010001
11110110000001011101010010011
1100000011010001110000001011
 11020101111100011001100011
  1100001   10001001010011
   100001111100010010100011
  110020000000021201010000111
 110000111012101111101111000111
1111N111 1110101 101111200001
11111111 1111111 111111111111
